102,102,102,102,0,0,0,0,0,0,0,0,0,0,152,153,138,139,172,173,138,139,152,153,0,0,244,245,0,0,0,0,0,0,0,0,102,102,102,102
102,102,102,102,0,0,0,0,14,15,10,11,40,41,0,1,8,9,2,3,40,41,0,0,6,7,2,3,38,39,16,17,0,0,0,0,102,102,102,102
102,102,102,102,0,0,0,0,0,0,0,0,0,0,0,0,0,0,0,0,0,0,0,0,0,0,0,0,0,0,0,0,0,0,0,0,102,102,102,102
102,102,102,0,98,99,0,0,0,0,0,0,0,0,0,0,0,0,0,0,98,99,0,0,0,0,0,0,0,0,0,0,0,0,98,99,0,102,102,102
102,102,0,0,0,0,0,96,0,0,0,0,0,0,0,96,0,0,0,0,0,0,0,0,0,96,0,0,0,0,0,0,96,0,0,0,0,0,102,102
54,55,54,55,54,55,54,55,54,55,54,55,54,55,54,55,54,55,54,55,54,55,54,55,54,55,54,55,54,55,54,55,54,55,54,55,54,55,54,55
104,105,54,55,54,55,54,55,0,104,105,104,105,104,105,104,105,104,105,104,105,104,105,104,105,104,105,104,105,104,105,0,54,55,54,55,54,55,104,105
0,0,106,55,54,55,54,107,0,0,0,0,0,0,0,0,0,0,0,0,0,0,0,0,0,0,0,0,0,0,0,0,106,55,54,55,54,107,0,0
0,0,0,106,54,55,107,0,0,0,0,0,0,0,0,0,0,0,0,0,0,0,0,0,0,0,0,0,0,0,0,0,0,106,54,55,107,0,0,0
0,0,0,0,54,55,0,0,0,0,0,0,0,0,0,0,0,0,0,0,0,0,0,0,0,0,0,0,0,0,0,0,0,0,54,55,0,0,0,0
0,0,0,0,54,55,0,0,0,0,0,0,0,0,0,0,0,0,0,0,0,0,0,0,0,0,0,0,0,0,0,0,0,0,54,55,0,0,0,0
0,0,0,0,54,55,0,0,0,0,0,0,0,0,0,0,0,0,0,0,0,0,0,0,0,0,0,0,0,0,0,0,0,0,54,55,0,0,0,0
