16,17,16,17,16,17,16,17,16,17,16,17,16,17,16,17,16,17,16,17,16,17,16,17,16,17,16,17,16,17,92,92,92,92,92,92,16,17,8,11
16,17,2,3,4,3,4,3,4,3,4,5,4,5,14,15,4,5,4,5,4,5,4,5,14,15,4,5,4,5,8,9,48,48,48,48,16,17,6,7
16,17,6,7,55,48,48,48,48,48,48,48,48,48,48,48,48,48,48,48,48,48,48,48,48,48,48,48,48,48,48,48,48,48,48,48,16,17,6,7
16,17,6,7,48,48,48,48,48,48,48,48,48,48,48,48,48,48,48,48,48,48,48,48,48,48,48,48,48,48,48,48,48,48,55,48,16,17,6,7
16,17,6,7,48,48,48,48,48,48,48,48,48,48,48,48,48,48,48,55,48,48,48,48,48,48,48,48,48,48,48,48,48,48,48,48,16,17,6,7
16,17,6,7,48,48,48,48,48,48,48,48,48,48,48,48,48,48,48,48,48,48,48,48,48,48,48,48,48,48,48,48,48,48,48,48,16,17,6,7
16,17,6,7,48,48,48,48,48,48,48,48,48,48,48,48,48,48,48,48,48,48,48,48,48,48,48,48,48,48,48,48,48,48,48,48,16,17,6,7
16,17,6,7,48,48,48,48,48,48,48,48,48,48,48,48,48,48,48,48,48,48,48,48,48,55,48,48,48,48,48,48,48,48,48,48,16,17,6,7
16,17,6,7,48,48,55,48,48,48,48,48,48,48,48,48,48,48,48,48,48,48,48,48,48,48,48,48,48,48,48,48,48,48,48,48,16,17,6,7
16,17,6,7,48,48,48,48,48,48,48,48,48,48,48,48,48,48,48,48,48,48,48,48,48,48,48,48,48,48,48,48,48,48,48,48,16,17,6,7
16,17,16,17,16,17,16,17,16,17,16,17,16,17,16,17,16,17,16,17,16,17,16,17,16,17,16,17,16,17,16,17,16,17,16,17,16,17,6,7
10,11,4,5,4,5,4,5,4,5,4,5,4,5,4,5,4,5,4,5,4,5,4,5,4,5,4,5,4,5,4,5,4,5,4,5,4,5,8,9
